#Tiles#
assets/grass1.png, 0, false
assets/Tile2.png, 1, true
assets/grass2.png, 2, false
assets/grass3.png, 3, false
#Map#
1,1,1,1,1,1,1,1,1,1,1,1,1,1,1
1,0,0,0,0,0,0,0,3,0,0,0,2,0,1
1,0,0,0,2,0,0,0,0,0,2,3,0,0,1
1,0,0,0,0,0,0,2,0,0,0,0,0,0,1
1,0,2,0,2,0,3,0,0,0,0,0,0,0,1
1,0,0,0,0,0,0,0,2,0,0,0,0,0,1
1,0,0,0,0,2,0,0,0,0,0,0,0,0,1
1,0,2,0,0,0,0,0,0,0,2,0,0,2,1
1,1,1,1,1,1,1,1,1,1,1,1,1,1,1